常見簡體字對照表（用於檢查）：
認證=認證
獲取=獲取
建立=建立
驗證=驗證
使用者=使用者
詳情=詳情
評論=評論
評語=評語
稽覈=審核
匯出=匯出
匯入=匯入
連線=連線
啟用=啟用
關閉=關閉
錯誤=錯誤
成功=成功
資料=資料
庫=庫
設定=設定
刪除=刪除
編輯=編輯
查詢=查詢
搜尋=搜尋
確認=確認
取消=取消
儲存=儲存
提交=提交
返回=返回
響應=響應
請求=請求
處理=處理
狀態=狀態
記錄=記錄
歷史=歷史
當前=當前
更新=更新
修改=修改
載入=載入
輸入=輸入
輸出=輸出
傳送=傳送
接收=接收
傳輸=傳輸
轉換=轉換
配置=配置
環境=環境
變數=變數
引數=引數
型別=型別
屬性=屬性
例項=例項
物件=物件
函式=函式
結果=結果
過程=過程
開發=開發
測試=測試
執行=執行
啟動=啟動
停止=停止
繼續=繼續
暫停=暫停
程式=程式
執行緒=執行緒
非同步=非同步
同步=同步
佇列=佇列
快取=快取
臨時=臨時
永久=永久
有效=有效
無效=無效
預設=預設
自定義=自定義
標準=標準
規則=規則
檢查=檢查
監控=監控
統計=統計
報告=報告
